Typography	字體排印學
formatting	格式設定
footnote	註腳
Bullets and Numbering	項目符號與編號
typeface	字樣	字型的 style 或 typeface，如標準、斜體等
Paste Special	選擇性貼上
click	點按
Italic	義式斜體	字型樣式
Headings	標題	樣式 -> Headings1, Headings2, ... etc.
Header	頁首	Header, header, headers
footnote	註腳	footnote=註腳，endnote=尾註
Slab Serif	粗平襯線體
tab	標籤頁
body text	內文
weight	字重	font weight 在第四章翻譯為字重，可以討論要統一為哪種說法。
copyright	著作權
memo	備忘錄
dummy text	假文
typographer	字體排印家
layout	版面配置	layout, layouts
Footer	頁尾	footer, footers
